10
10
1110011111
1116000041
1100011111
1101211111
1101011111
1101011111
1100011111
1111111111
1111111111
1111111111