10
11
11100111111
11160111111
11000111111
11012111111
11010111111
11010111111
11000000411
11111111111
11111111111
11111111111