10
11
11100111111
11160011111
11000111111
11012111111
11010111111
11010000411
11000111111
11111111111
11111111111
11111111111